10 20
|------------------|
|F..|..............|
|FF...P............|
|.....@|...........|
|.P....|...........|
|.P....|...........|
|.P....|...........|
|.P....|...........|
|.P....|...........|
|------------------|